##############################
#.........#..................#
#....T....#.......#......S...#
#.................#..........#
#.........#..E....#..........#
#.........#.......#..A.......#
#.J.......#.......#........P.#
##############################
#.................#...E......#
#.........#...E...#....T.....#
#....S....#.......#..........#
#........E#...............F..#
#P........#..................#
##############################